"","teamID","yearID","lgID","G","W","L","R","RA","RD"
"1","ANA",2001,"AL",162,75,87,691,730,-39
"2","ARI",2001,"NL",162,92,70,818,677,141
"3","ATL",2001,"NL",162,88,74,729,643,86
"4","BAL",2001,"AL",162,63,98,687,829,-142
"5","BOS",2001,"AL",161,82,79,772,745,27
"6","CHA",2001,"AL",162,83,79,798,795,3
"7","CHN",2001,"NL",162,88,74,777,701,76
"8","CIN",2001,"NL",162,66,96,735,850,-115
"9","CLE",2001,"AL",162,91,71,897,821,76
"10","COL",2001,"NL",162,73,89,923,906,17
"11","DET",2001,"AL",162,66,96,724,876,-152
"12","FLO",2001,"NL",162,76,86,742,744,-2
"13","HOU",2001,"NL",162,93,69,847,769,78
"14","KCA",2001,"AL",162,65,97,729,858,-129
"15","LAN",2001,"NL",162,86,76,758,744,14
"16","MIL",2001,"NL",162,68,94,740,806,-66
"17","MIN",2001,"AL",162,85,77,771,766,5
"18","MON",2001,"NL",162,68,94,670,812,-142
"19","NYA",2001,"AL",161,95,65,804,713,91
"20","NYN",2001,"NL",162,82,80,642,713,-71
"21","OAK",2001,"AL",162,102,60,884,645,239
"22","PHI",2001,"NL",162,86,76,746,719,27
"23","PIT",2001,"NL",162,62,100,657,858,-201
"24","SDN",2001,"NL",162,79,83,789,812,-23
"25","SEA",2001,"AL",162,116,46,927,627,300
"26","SFN",2001,"NL",162,90,72,799,748,51
"27","SLN",2001,"NL",162,93,69,814,684,130
"28","TBA",2001,"AL",162,62,100,672,887,-215
"29","TEX",2001,"AL",162,73,89,890,968,-78
"30","TOR",2001,"AL",162,80,82,767,753,14
"31","ANA",2002,"AL",162,99,63,851,644,207
"32","ARI",2002,"NL",162,98,64,819,674,145
"33","ATL",2002,"NL",161,101,59,708,565,143
"34","BAL",2002,"AL",162,67,95,667,773,-106
"35","BOS",2002,"AL",162,93,69,859,665,194
"36","CHA",2002,"AL",162,81,81,856,798,58
"37","CHN",2002,"NL",162,67,95,706,759,-53
"38","CIN",2002,"NL",162,78,84,709,774,-65
"39","CLE",2002,"AL",162,74,88,739,837,-98
"40","COL",2002,"NL",162,73,89,778,898,-120
"41","DET",2002,"AL",161,55,106,575,864,-289
"42","FLO",2002,"NL",162,79,83,699,763,-64
"43","HOU",2002,"NL",162,84,78,749,695,54
"44","KCA",2002,"AL",162,62,100,737,891,-154
"45","LAN",2002,"NL",162,92,70,713,643,70
"46","MIL",2002,"NL",162,56,106,627,821,-194
"47","MIN",2002,"AL",161,94,67,768,712,56
"48","MON",2002,"NL",162,83,79,735,718,17
"49","NYA",2002,"AL",161,103,58,897,697,200
"50","NYN",2002,"NL",161,75,86,690,703,-13
"51","OAK",2002,"AL",162,103,59,800,654,146
"52","PHI",2002,"NL",161,80,81,710,724,-14
"53","PIT",2002,"NL",161,72,89,641,730,-89
"54","SDN",2002,"NL",162,66,96,662,815,-153
"55","SEA",2002,"AL",162,93,69,814,699,115
"56","SFN",2002,"NL",162,95,66,783,616,167
"57","SLN",2002,"NL",162,97,65,787,648,139
"58","TBA",2002,"AL",161,55,106,673,918,-245
"59","TEX",2002,"AL",162,72,90,843,882,-39
"60","TOR",2002,"AL",162,78,84,813,828,-15
"61","ANA",2003,"AL",162,77,85,736,743,-7
"62","ARI",2003,"NL",162,84,78,717,685,32
"63","ATL",2003,"NL",162,101,61,907,740,167
"64","BAL",2003,"AL",163,71,91,743,820,-77
"65","BOS",2003,"AL",162,95,67,961,809,152
"66","CHA",2003,"AL",162,86,76,791,715,76
"67","CHN",2003,"NL",162,88,74,724,683,41
"68","CIN",2003,"NL",162,69,93,694,886,-192
"69","CLE",2003,"AL",162,68,94,699,778,-79
"70","COL",2003,"NL",162,74,88,853,892,-39
"71","DET",2003,"AL",162,43,119,591,928,-337
"72","FLO",2003,"NL",162,91,71,751,692,59
"73","HOU",2003,"NL",162,87,75,805,677,128
"74","KCA",2003,"AL",162,83,79,836,867,-31
"75","LAN",2003,"NL",162,85,77,574,556,18
"76","MIL",2003,"NL",162,68,94,714,873,-159
"77","MIN",2003,"AL",162,90,72,801,758,43
"78","MON",2003,"NL",162,83,79,711,716,-5
"79","NYA",2003,"AL",163,101,61,877,716,161
"80","NYN",2003,"NL",161,66,95,642,754,-112
"81","OAK",2003,"AL",162,96,66,768,643,125
"82","PHI",2003,"NL",162,86,76,791,697,94
"83","PIT",2003,"NL",162,75,87,753,801,-48
"84","SDN",2003,"NL",162,64,98,678,831,-153
"85","SEA",2003,"AL",162,93,69,795,637,158
"86","SFN",2003,"NL",161,100,61,755,638,117
"87","SLN",2003,"NL",162,85,77,876,796,80
"88","TBA",2003,"AL",162,63,99,715,852,-137
"89","TEX",2003,"AL",162,71,91,826,969,-143
"90","TOR",2003,"AL",162,86,76,894,826,68
"91","ANA",2004,"AL",162,92,70,836,734,102
"92","ARI",2004,"NL",162,51,111,615,899,-284
"93","ATL",2004,"NL",162,96,66,803,668,135
"94","BAL",2004,"AL",162,78,84,842,830,12
"95","BOS",2004,"AL",162,98,64,949,768,181
"96","CHA",2004,"AL",162,83,79,865,831,34
"97","CHN",2004,"NL",162,89,73,789,665,124
"98","CIN",2004,"NL",162,76,86,750,907,-157
"99","CLE",2004,"AL",162,80,82,858,857,1
"100","COL",2004,"NL",162,68,94,833,923,-90
"101","DET",2004,"AL",162,72,90,827,844,-17
"102","FLO",2004,"NL",162,83,79,718,700,18
"103","HOU",2004,"NL",162,92,70,803,698,105
"104","KCA",2004,"AL",162,58,104,720,905,-185
"105","LAN",2004,"NL",162,93,69,761,684,77
"106","MIL",2004,"NL",161,67,94,634,757,-123
"107","MIN",2004,"AL",162,92,70,780,715,65
"108","MON",2004,"NL",162,67,95,635,769,-134
"109","NYA",2004,"AL",162,101,61,897,808,89
"110","NYN",2004,"NL",162,71,91,684,731,-47
"111","OAK",2004,"AL",162,91,71,793,742,51
"112","PHI",2004,"NL",162,86,76,840,781,59
"113","PIT",2004,"NL",161,72,89,680,744,-64
"114","SDN",2004,"NL",162,87,75,768,705,63
"115","SEA",2004,"AL",162,63,99,698,823,-125
"116","SFN",2004,"NL",162,91,71,850,770,80
"117","SLN",2004,"NL",162,105,57,855,659,196
"118","TBA",2004,"AL",161,70,91,714,842,-128
"119","TEX",2004,"AL",162,89,73,860,794,66
"120","TOR",2004,"AL",161,67,94,719,823,-104
"121","ARI",2005,"NL",162,77,85,696,856,-160
"122","ATL",2005,"NL",162,90,72,769,674,95
"123","BAL",2005,"AL",162,74,88,729,800,-71
"124","BOS",2005,"AL",162,95,67,910,805,105
"125","CHA",2005,"AL",162,99,63,741,645,96
"126","CHN",2005,"NL",162,79,83,703,714,-11
"127","CIN",2005,"NL",163,73,89,820,889,-69
"128","CLE",2005,"AL",162,93,69,790,642,148
"129","COL",2005,"NL",162,67,95,740,862,-122
"130","DET",2005,"AL",162,71,91,723,787,-64
"131","FLO",2005,"NL",162,83,79,717,732,-15
"132","HOU",2005,"NL",163,89,73,693,609,84
"133","KCA",2005,"AL",162,56,106,701,935,-234
"134","LAA",2005,"AL",162,95,67,761,643,118
"135","LAN",2005,"NL",162,71,91,685,755,-70
"136","MIL",2005,"NL",162,81,81,726,697,29
"137","MIN",2005,"AL",162,83,79,688,662,26
"138","NYA",2005,"AL",162,95,67,886,789,97
"139","NYN",2005,"NL",162,83,79,722,648,74
"140","OAK",2005,"AL",162,88,74,772,658,114
"141","PHI",2005,"NL",162,88,74,807,726,81
"142","PIT",2005,"NL",162,67,95,680,769,-89
"143","SDN",2005,"NL",162,82,80,684,726,-42
"144","SEA",2005,"AL",162,69,93,699,751,-52
"145","SFN",2005,"NL",162,75,87,649,745,-96
"146","SLN",2005,"NL",162,100,62,805,634,171
"147","TBA",2005,"AL",162,67,95,750,936,-186
"148","TEX",2005,"AL",162,79,83,865,858,7
"149","TOR",2005,"AL",162,80,82,775,705,70
"150","WAS",2005,"NL",162,81,81,639,673,-34
"151","ARI",2006,"NL",162,76,86,773,788,-15
"152","ATL",2006,"NL",162,79,83,849,805,44
"153","BAL",2006,"AL",162,70,92,768,899,-131
"154","BOS",2006,"AL",162,86,76,820,825,-5
"155","CHA",2006,"AL",162,90,72,868,794,74
"156","CHN",2006,"NL",162,66,96,716,834,-118
"157","CIN",2006,"NL",162,80,82,749,801,-52
"158","CLE",2006,"AL",162,78,84,870,782,88
"159","COL",2006,"NL",162,76,86,813,812,1
"160","DET",2006,"AL",162,95,67,822,675,147
"161","FLO",2006,"NL",162,78,84,758,772,-14
"162","HOU",2006,"NL",162,82,80,735,719,16
"163","KCA",2006,"AL",162,62,100,757,971,-214
"164","LAA",2006,"AL",162,89,73,766,732,34
"165","LAN",2006,"NL",162,88,74,820,751,69
"166","MIL",2006,"NL",162,75,87,730,833,-103
"167","MIN",2006,"AL",162,96,66,801,683,118
"168","NYA",2006,"AL",162,97,65,930,767,163
"169","NYN",2006,"NL",162,97,65,834,731,103
"170","OAK",2006,"AL",162,93,69,771,727,44
"171","PHI",2006,"NL",162,85,77,865,812,53
"172","PIT",2006,"NL",162,67,95,691,797,-106
"173","SDN",2006,"NL",162,88,74,731,679,52
"174","SEA",2006,"AL",162,78,84,756,792,-36
"175","SFN",2006,"NL",161,76,85,746,790,-44
"176","SLN",2006,"NL",161,83,78,781,762,19
"177","TBA",2006,"AL",162,61,101,689,856,-167
"178","TEX",2006,"AL",162,80,82,835,784,51
"179","TOR",2006,"AL",162,87,75,809,754,55
"180","WAS",2006,"NL",162,71,91,746,872,-126
"181","ARI",2007,"NL",162,90,72,712,732,-20
"182","ATL",2007,"NL",162,84,78,810,733,77
"183","BAL",2007,"AL",162,69,93,756,868,-112
"184","BOS",2007,"AL",162,96,66,867,657,210
"185","CHA",2007,"AL",162,72,90,693,839,-146
"186","CHN",2007,"NL",162,85,77,752,690,62
"187","CIN",2007,"NL",162,72,90,783,853,-70
"188","CLE",2007,"AL",162,96,66,811,704,107
"189","COL",2007,"NL",163,90,73,860,758,102
"190","DET",2007,"AL",162,88,74,887,797,90
"191","FLO",2007,"NL",162,71,91,790,891,-101
"192","HOU",2007,"NL",162,73,89,723,813,-90
"193","KCA",2007,"AL",162,69,93,706,778,-72
"194","LAA",2007,"AL",162,94,68,822,731,91
"195","LAN",2007,"NL",162,82,80,735,727,8
"196","MIL",2007,"NL",162,83,79,801,776,25
"197","MIN",2007,"AL",162,79,83,718,725,-7
"198","NYA",2007,"AL",162,94,68,968,777,191
"199","NYN",2007,"NL",162,88,74,804,750,54
"200","OAK",2007,"AL",162,76,86,741,758,-17
"201","PHI",2007,"NL",162,89,73,892,821,71
"202","PIT",2007,"NL",162,68,94,724,846,-122
"203","SDN",2007,"NL",163,89,74,741,666,75
"204","SEA",2007,"AL",162,88,74,794,813,-19
"205","SFN",2007,"NL",162,71,91,683,720,-37
"206","SLN",2007,"NL",162,78,84,725,829,-104
"207","TBA",2007,"AL",162,66,96,782,944,-162
"208","TEX",2007,"AL",162,75,87,816,844,-28
"209","TOR",2007,"AL",162,83,79,753,699,54
"210","WAS",2007,"NL",162,73,89,673,783,-110
"211","ARI",2008,"NL",162,82,80,720,706,14
"212","ATL",2008,"NL",162,72,90,753,778,-25
"213","BAL",2008,"AL",161,68,93,782,869,-87
"214","BOS",2008,"AL",162,95,67,845,694,151
"215","CHA",2008,"AL",163,89,74,811,729,82
"216","CHN",2008,"NL",161,97,64,855,671,184
"217","CIN",2008,"NL",162,74,88,704,800,-96
"218","CLE",2008,"AL",162,81,81,805,761,44
"219","COL",2008,"NL",162,74,88,747,822,-75
"220","DET",2008,"AL",162,74,88,821,857,-36
"221","FLO",2008,"NL",161,84,77,770,767,3
"222","HOU",2008,"NL",161,86,75,712,743,-31
"223","KCA",2008,"AL",162,75,87,691,781,-90
"224","LAA",2008,"AL",162,100,62,765,697,68
"225","LAN",2008,"NL",162,84,78,700,648,52
"226","MIL",2008,"NL",162,90,72,750,689,61
"227","MIN",2008,"AL",163,88,75,829,745,84
"228","NYA",2008,"AL",162,89,73,789,727,62
"229","NYN",2008,"NL",162,89,73,799,715,84
"230","OAK",2008,"AL",161,75,86,646,690,-44
"231","PHI",2008,"NL",162,92,70,799,680,119
"232","PIT",2008,"NL",162,67,95,735,884,-149
"233","SDN",2008,"NL",162,63,99,637,764,-127
"234","SEA",2008,"AL",162,61,101,671,811,-140
"235","SFN",2008,"NL",162,72,90,640,759,-119
"236","SLN",2008,"NL",162,86,76,779,725,54
"237","TBA",2008,"AL",162,97,65,774,671,103
"238","TEX",2008,"AL",162,79,83,901,967,-66
"239","TOR",2008,"AL",162,86,76,714,610,104
"240","WAS",2008,"NL",161,59,102,641,825,-184
"241","ARI",2009,"NL",162,70,92,720,782,-62
"242","ATL",2009,"NL",162,86,76,735,641,94
"243","BAL",2009,"AL",162,64,98,741,876,-135
"244","BOS",2009,"AL",162,95,67,872,736,136
"245","CHA",2009,"AL",162,79,83,724,732,-8
"246","CHN",2009,"NL",161,83,78,707,672,35
"247","CIN",2009,"NL",162,78,84,673,723,-50
"248","CLE",2009,"AL",162,65,97,773,865,-92
"249","COL",2009,"NL",162,92,70,804,715,89
"250","DET",2009,"AL",163,86,77,743,745,-2
"251","FLO",2009,"NL",162,87,75,772,766,6
"252","HOU",2009,"NL",162,74,88,643,770,-127
"253","KCA",2009,"AL",162,65,97,686,842,-156
"254","LAA",2009,"AL",162,97,65,883,761,122
"255","LAN",2009,"NL",162,95,67,780,611,169
"256","MIL",2009,"NL",162,80,82,785,818,-33
"257","MIN",2009,"AL",163,87,76,817,765,52
"258","NYA",2009,"AL",162,103,59,915,753,162
"259","NYN",2009,"NL",162,70,92,671,757,-86
"260","OAK",2009,"AL",162,75,87,759,761,-2
"261","PHI",2009,"NL",162,93,69,820,709,111
"262","PIT",2009,"NL",161,62,99,636,768,-132
"263","SDN",2009,"NL",162,75,87,638,769,-131
"264","SEA",2009,"AL",162,85,77,640,692,-52
"265","SFN",2009,"NL",162,88,74,657,611,46
"266","SLN",2009,"NL",162,91,71,730,640,90
"267","TBA",2009,"AL",162,84,78,803,754,49
"268","TEX",2009,"AL",162,87,75,784,740,44
"269","TOR",2009,"AL",162,75,87,798,771,27
"270","WAS",2009,"NL",162,59,103,710,874,-164
"271","ARI",2010,"NL",162,65,97,713,836,-123
"272","ATL",2010,"NL",162,91,71,738,629,109
"273","BAL",2010,"AL",162,66,96,613,785,-172
"274","BOS",2010,"AL",162,89,73,818,744,74
"275","CHA",2010,"AL",162,88,74,752,704,48
"276","CHN",2010,"NL",162,75,87,685,767,-82
"277","CIN",2010,"NL",162,91,71,790,685,105
"278","CLE",2010,"AL",162,69,93,646,752,-106
"279","COL",2010,"NL",162,83,79,770,717,53
"280","DET",2010,"AL",162,81,81,751,743,8
"281","FLO",2010,"NL",162,80,82,719,717,2
"282","HOU",2010,"NL",162,76,86,611,729,-118
"283","KCA",2010,"AL",162,67,95,676,845,-169
"284","LAA",2010,"AL",162,80,82,681,702,-21
"285","LAN",2010,"NL",162,80,82,667,692,-25
"286","MIL",2010,"NL",162,77,85,750,804,-54
"287","MIN",2010,"AL",162,94,68,781,671,110
"288","NYA",2010,"AL",162,95,67,859,693,166
"289","NYN",2010,"NL",162,79,83,656,652,4
"290","OAK",2010,"AL",162,81,81,663,626,37
"291","PHI",2010,"NL",162,97,65,772,640,132
"292","PIT",2010,"NL",162,57,105,587,866,-279
"293","SDN",2010,"NL",162,90,72,665,581,84
"294","SEA",2010,"AL",162,61,101,513,698,-185
"295","SFN",2010,"NL",162,92,70,697,583,114
"296","SLN",2010,"NL",162,86,76,736,641,95
"297","TBA",2010,"AL",162,96,66,802,649,153
"298","TEX",2010,"AL",162,90,72,787,687,100
"299","TOR",2010,"AL",162,85,77,755,728,27
"300","WAS",2010,"NL",162,69,93,655,742,-87
"301","ARI",2011,"NL",162,94,68,731,662,69
"302","ATL",2011,"NL",162,89,73,641,605,36
"303","BAL",2011,"AL",162,69,93,708,860,-152
"304","BOS",2011,"AL",162,90,72,875,737,138
"305","CHA",2011,"AL",162,79,83,654,706,-52
"306","CHN",2011,"NL",162,71,91,654,756,-102
"307","CIN",2011,"NL",162,79,83,735,720,15
"308","CLE",2011,"AL",162,80,82,704,760,-56
"309","COL",2011,"NL",162,73,89,735,774,-39
"310","DET",2011,"AL",162,95,67,787,711,76
"311","FLO",2011,"NL",162,72,90,625,702,-77
"312","HOU",2011,"NL",162,56,106,615,796,-181
"313","KCA",2011,"AL",162,71,91,730,762,-32
"314","LAA",2011,"AL",162,86,76,667,633,34
"315","LAN",2011,"NL",161,82,79,644,612,32
"316","MIL",2011,"NL",162,96,66,721,638,83
"317","MIN",2011,"AL",162,63,99,619,804,-185
"318","NYA",2011,"AL",162,97,65,867,657,210
"319","NYN",2011,"NL",162,77,85,718,742,-24
"320","OAK",2011,"AL",162,74,88,645,679,-34
"321","PHI",2011,"NL",162,102,60,713,529,184
"322","PIT",2011,"NL",162,72,90,610,712,-102
"323","SDN",2011,"NL",162,71,91,593,611,-18
"324","SEA",2011,"AL",162,67,95,556,675,-119
"325","SFN",2011,"NL",162,86,76,570,578,-8
"326","SLN",2011,"NL",162,90,72,762,692,70
"327","TBA",2011,"AL",162,91,71,707,614,93
"328","TEX",2011,"AL",162,96,66,855,677,178
"329","TOR",2011,"AL",162,81,81,743,761,-18
"330","WAS",2011,"NL",161,80,81,624,643,-19
"331","ARI",2012,"NL",162,81,81,734,688,46
"332","ATL",2012,"NL",162,94,68,700,600,100
"333","BAL",2012,"AL",162,93,69,712,705,7
"334","BOS",2012,"AL",162,69,93,734,806,-72
"335","CHA",2012,"AL",162,85,77,748,676,72
"336","CHN",2012,"NL",162,61,101,613,759,-146
"337","CIN",2012,"NL",162,97,65,669,588,81
"338","CLE",2012,"AL",162,68,94,667,845,-178
"339","COL",2012,"NL",162,64,98,758,890,-132
"340","DET",2012,"AL",162,88,74,726,670,56
"341","HOU",2012,"NL",162,55,107,583,794,-211
"342","KCA",2012,"AL",162,72,90,676,746,-70
"343","LAA",2012,"AL",162,89,73,767,699,68
"344","LAN",2012,"NL",162,86,76,637,597,40
"345","MIA",2012,"NL",162,69,93,609,724,-115
"346","MIL",2012,"NL",162,83,79,776,733,43
"347","MIN",2012,"AL",162,66,96,701,832,-131
"348","NYA",2012,"AL",162,95,67,804,668,136
"349","NYN",2012,"NL",162,74,88,650,709,-59
"350","OAK",2012,"AL",162,94,68,713,614,99
"351","PHI",2012,"NL",162,81,81,684,680,4
"352","PIT",2012,"NL",162,79,83,651,674,-23
"353","SDN",2012,"NL",162,76,86,651,710,-59
"354","SEA",2012,"AL",162,75,87,619,651,-32
"355","SFN",2012,"NL",162,94,68,718,649,69
"356","SLN",2012,"NL",162,88,74,765,648,117
"357","TBA",2012,"AL",162,90,72,697,577,120
"358","TEX",2012,"AL",162,93,69,808,707,101
"359","TOR",2012,"AL",162,73,89,716,784,-68
"360","WAS",2012,"NL",162,98,64,731,594,137
"361","ARI",2013,"NL",162,81,81,685,695,-10
"362","ATL",2013,"NL",162,96,66,688,548,140
"363","BAL",2013,"AL",162,85,77,745,709,36
"364","BOS",2013,"AL",162,97,65,853,656,197
"365","CHA",2013,"AL",162,63,99,598,723,-125
"366","CHN",2013,"NL",162,66,96,602,689,-87
"367","CIN",2013,"NL",162,90,72,698,589,109
"368","CLE",2013,"AL",162,92,70,745,662,83
"369","COL",2013,"NL",162,74,88,706,760,-54
"370","DET",2013,"AL",162,93,69,796,624,172
"371","HOU",2013,"AL",162,51,111,610,848,-238
"372","KCA",2013,"AL",162,86,76,648,601,47
"373","LAA",2013,"AL",162,78,84,733,737,-4
"374","LAN",2013,"NL",162,92,70,649,582,67
"375","MIA",2013,"NL",162,62,100,513,646,-133
"376","MIL",2013,"NL",162,74,88,640,687,-47
"377","MIN",2013,"AL",162,66,96,614,788,-174
"378","NYA",2013,"AL",162,85,77,650,671,-21
"379","NYN",2013,"NL",162,74,88,619,684,-65
"380","OAK",2013,"AL",162,96,66,767,625,142
"381","PHI",2013,"NL",162,73,89,610,749,-139
"382","PIT",2013,"NL",162,94,68,634,577,57
"383","SDN",2013,"NL",162,76,86,618,700,-82
"384","SEA",2013,"AL",162,71,91,624,754,-130
"385","SFN",2013,"NL",162,76,86,629,691,-62
"386","SLN",2013,"NL",162,97,65,783,596,187
"387","TBA",2013,"AL",163,92,71,700,646,54
"388","TEX",2013,"AL",163,91,72,730,636,94
"389","TOR",2013,"AL",162,74,88,712,756,-44
"390","WAS",2013,"NL",162,86,76,656,626,30
"391","ARI",2014,"NL",162,64,98,615,742,-127
"392","ATL",2014,"NL",162,79,83,573,597,-24
"393","BAL",2014,"AL",162,96,66,705,593,112
"394","BOS",2014,"AL",162,71,91,634,715,-81
"395","CHA",2014,"AL",162,73,89,660,758,-98
"396","CHN",2014,"NL",162,73,89,614,707,-93
"397","CIN",2014,"NL",162,76,86,595,612,-17
"398","CLE",2014,"AL",162,85,77,669,653,16
"399","COL",2014,"NL",162,66,96,755,818,-63
"400","DET",2014,"AL",162,90,72,757,705,52
"401","HOU",2014,"AL",162,70,92,629,723,-94
"402","KCA",2014,"AL",162,89,73,651,624,27
"403","LAA",2014,"AL",162,98,64,773,630,143
"404","LAN",2014,"NL",162,94,68,718,617,101
"405","MIA",2014,"NL",162,77,85,645,674,-29
"406","MIL",2014,"NL",162,82,80,650,657,-7
"407","MIN",2014,"AL",162,70,92,715,777,-62
"408","NYA",2014,"AL",162,84,78,633,664,-31
"409","NYN",2014,"NL",162,79,83,629,618,11
"410","OAK",2014,"AL",162,88,74,729,572,157
"411","PHI",2014,"NL",162,73,89,619,687,-68
"412","PIT",2014,"NL",162,88,74,682,631,51
"413","SDN",2014,"NL",162,77,85,535,577,-42
"414","SEA",2014,"AL",162,87,75,634,554,80
"415","SFN",2014,"NL",162,88,74,665,614,51
"416","SLN",2014,"NL",162,90,72,619,603,16
"417","TBA",2014,"AL",162,77,85,612,625,-13
"418","TEX",2014,"AL",162,67,95,637,773,-136
"419","TOR",2014,"AL",162,83,79,723,686,37
"420","WAS",2014,"NL",162,96,66,686,555,131
"421","ARI",2015,"NL",162,79,83,720,713,7
"422","ATL",2015,"NL",162,67,95,573,760,-187
"423","BAL",2015,"AL",162,81,81,713,693,20
"424","BOS",2015,"AL",162,78,84,748,753,-5
"425","CHA",2015,"AL",162,76,86,622,701,-79
"426","CHN",2015,"NL",162,97,65,689,608,81
"427","CIN",2015,"NL",162,64,98,640,754,-114
"428","CLE",2015,"AL",161,81,80,669,640,29
"429","COL",2015,"NL",162,68,94,737,844,-107
"430","DET",2015,"AL",161,74,87,689,803,-114
"431","HOU",2015,"AL",162,86,76,729,618,111
"432","KCA",2015,"AL",162,95,67,724,641,83
"433","LAA",2015,"AL",162,85,77,661,675,-14
"434","LAN",2015,"NL",162,92,70,667,595,72
"435","MIA",2015,"NL",162,71,91,613,678,-65
"436","MIL",2015,"NL",162,68,94,655,737,-82
"437","MIN",2015,"AL",162,83,79,696,700,-4
"438","NYA",2015,"AL",162,87,75,764,698,66
"439","NYN",2015,"NL",162,90,72,683,613,70
"440","OAK",2015,"AL",162,68,94,694,729,-35
"441","PHI",2015,"NL",162,63,99,626,809,-183
"442","PIT",2015,"NL",162,98,64,697,596,101
"443","SDN",2015,"NL",162,74,88,650,731,-81
"444","SEA",2015,"AL",162,76,86,656,726,-70
"445","SFN",2015,"NL",162,84,78,696,627,69
"446","SLN",2015,"NL",162,100,62,647,525,122
"447","TBA",2015,"AL",162,80,82,644,642,2
"448","TEX",2015,"AL",162,88,74,751,733,18
"449","TOR",2015,"AL",162,93,69,891,670,221
"450","WAS",2015,"NL",162,83,79,703,635,68
"451","ARI",2016,"NL",162,69,93,752,890,-138
"452","ATL",2016,"NL",161,68,93,649,779,-130
"453","BAL",2016,"AL",162,89,73,744,715,29
"454","BOS",2016,"AL",162,93,69,878,694,184
"455","CHA",2016,"AL",162,78,84,686,715,-29
"456","CHN",2016,"NL",162,103,58,808,556,252
"457","CIN",2016,"NL",162,68,94,716,854,-138
"458","CLE",2016,"AL",161,94,67,777,676,101
"459","COL",2016,"NL",162,75,87,845,860,-15
"460","DET",2016,"AL",161,86,75,750,721,29
"461","HOU",2016,"AL",162,84,78,724,701,23
"462","KCA",2016,"AL",162,81,81,675,712,-37
"463","LAA",2016,"AL",162,74,88,717,727,-10
"464","LAN",2016,"NL",162,91,71,725,638,87
"465","MIA",2016,"NL",161,79,82,655,682,-27
"466","MIL",2016,"NL",162,73,89,671,733,-62
"467","MIN",2016,"AL",162,59,103,722,889,-167
"468","NYA",2016,"AL",162,84,78,680,702,-22
"469","NYN",2016,"NL",162,87,75,671,617,54
"470","OAK",2016,"AL",162,69,93,653,761,-108
"471","PHI",2016,"NL",162,71,91,610,796,-186
"472","PIT",2016,"NL",162,78,83,729,758,-29
"473","SDN",2016,"NL",162,68,94,686,770,-84
"474","SEA",2016,"AL",162,86,76,768,707,61
"475","SFN",2016,"NL",162,87,75,715,631,84
"476","SLN",2016,"NL",162,86,76,779,712,67
"477","TBA",2016,"AL",162,68,94,672,713,-41
"478","TEX",2016,"AL",162,95,67,765,757,8
"479","TOR",2016,"AL",162,89,73,759,666,93
"480","WAS",2016,"NL",162,95,67,763,612,151
"481","ARI",2017,"NL",162,93,69,812,659,153
"482","ATL",2017,"NL",162,72,90,732,821,-89
"483","BAL",2017,"AL",162,75,87,743,841,-98
"484","BOS",2017,"AL",162,93,69,785,668,117
"485","CHA",2017,"AL",162,67,95,706,820,-114
"486","CHN",2017,"NL",162,92,70,822,695,127
"487","CIN",2017,"NL",162,68,94,753,869,-116
"488","CLE",2017,"AL",162,102,60,818,564,254
"489","COL",2017,"NL",162,87,75,824,757,67
"490","DET",2017,"AL",162,64,98,735,894,-159
"491","HOU",2017,"AL",162,101,61,896,700,196
"492","KCA",2017,"AL",162,80,82,702,791,-89
"493","LAA",2017,"AL",162,80,82,710,709,1
"494","LAN",2017,"NL",162,104,58,770,580,190
"495","MIA",2017,"NL",162,77,85,778,822,-44
"496","MIL",2017,"NL",162,86,76,732,697,35
"497","MIN",2017,"AL",162,85,77,815,788,27
"498","NYA",2017,"AL",162,91,71,858,660,198
"499","NYN",2017,"NL",162,70,92,735,863,-128
"500","OAK",2017,"AL",162,75,87,739,826,-87
"501","PHI",2017,"NL",162,66,96,690,782,-92
"502","PIT",2017,"NL",162,75,87,668,731,-63
"503","SDN",2017,"NL",162,71,91,604,816,-212
"504","SEA",2017,"AL",162,78,84,750,772,-22
"505","SFN",2017,"NL",162,64,98,639,776,-137
"506","SLN",2017,"NL",162,83,79,761,705,56
"507","TBA",2017,"AL",162,80,82,694,704,-10
"508","TEX",2017,"AL",162,78,84,799,816,-17
"509","TOR",2017,"AL",162,76,86,693,784,-91
"510","WAS",2017,"NL",162,97,65,819,672,147
"511","ARI",2018,"NL",162,82,80,693,644,49
"512","ATL",2018,"NL",162,90,72,759,657,102
"513","BAL",2018,"AL",162,47,115,622,892,-270
"514","BOS",2018,"AL",162,108,54,876,647,229
"515","CHA",2018,"AL",162,62,100,656,848,-192
"516","CHN",2018,"NL",163,95,68,761,645,116
"517","CIN",2018,"NL",162,67,95,696,819,-123
"518","CLE",2018,"AL",162,91,71,818,648,170
"519","COL",2018,"NL",163,91,72,780,745,35
"520","DET",2018,"AL",162,64,98,630,796,-166
"521","HOU",2018,"AL",162,103,59,797,534,263
"522","KCA",2018,"AL",162,58,104,638,833,-195
"523","LAA",2018,"AL",162,80,82,721,722,-1
"524","LAN",2018,"NL",163,92,71,804,610,194
"525","MIA",2018,"NL",161,63,98,589,809,-220
"526","MIL",2018,"NL",163,96,67,754,659,95
"527","MIN",2018,"AL",162,78,84,738,775,-37
"528","NYA",2018,"AL",162,100,62,851,669,182
"529","NYN",2018,"NL",162,77,85,676,707,-31
"530","OAK",2018,"AL",162,97,65,813,674,139
"531","PHI",2018,"NL",162,80,82,677,728,-51
"532","PIT",2018,"NL",161,82,79,692,693,-1
"533","SDN",2018,"NL",162,66,96,617,767,-150
"534","SEA",2018,"AL",162,89,73,677,711,-34
"535","SFN",2018,"NL",162,73,89,603,699,-96
"536","SLN",2018,"NL",162,88,74,759,691,68
"537","TBA",2018,"AL",162,90,72,716,646,70
"538","TEX",2018,"AL",162,67,95,737,848,-111
"539","TOR",2018,"AL",162,73,89,709,832,-123
"540","WAS",2018,"NL",162,82,80,771,682,89
